%%%%%%%%%%%%
% P .      %
% ........ %
% %%%%%%%% %
% . .      %
%. G ..... %
%%%%%%%%%%%%
