%%%%%%%%%%%%%%%
%  ......     %
%             %
%...%%%%%%%...%
%    ......   %
%      P      %
%%%%%%%%%%%%%%%