%%%%%%%%%%%%%%%%%%%%
% ...%       .%.   %
%.%%.%........%.%%.%
%.. ........... .%.%
%...%%.... ........%
%.     .    ..    .%
%.%.%%........%%.%.%
%.%.......... ...%.%
%.%%.%.%%%%%%.%.%%.%
%.   %...P    %... %
%%%%%%%%%%%%%%%%%%%%
