%%%%%%%%%%%%%%%%%%%%
% ...%       .%.   %
%.%%.%.%%%%%%.%.%%.%
%.%             .%.%
%.%.%%.%%  %%.%%.%.%
%.     %G  G%.    .%
%.%.%%.%%%%%%.%%.%.%
%.%..         ...%.%
%.%%.%.%%%%%%.%.%%.%
%.   %...P    %... %
%%%%%%%%%%%%%%%%%%%%
