%%%%%%%%%%%%%%%%%%%%
% ...%       .%.   %
%.%%.%.%%%%%% %.%%.%
%.%             .%.%
%.%.%%.       %%.%.%
%.                .%
%.%.%%.       %%.%.%
%.%..          ..%.%
%.%%.%.%%%%%% %.%%.%
%.   %...P    %... %
%%%%%%%%%%%%%%%%%%%%
