%%%%%%%%%%%%
% P .      %
%     ...  %
% %%%%%%%%%%
% . .      %
%. G ..... %
%%%%%%%%%%%%
